####...####
#..+...-..#
#.........#
...........
....@#/#...
......5....
#....#....#
#.........#
#.*.......#
#..2.4..1.#
####...####