############
###.2#....##
#.4..#.....#
#..####....#
#..#...5...#
#..#+.##...#
#..####*...#
#....1####.#
#..#..#..#.#
#@.#......4#
############